{
  "name": "house",
  "width": 18,
  "height": 13,
  "tile_size": 16,
  "is_main": false,
  "tile_mapping": {
      "tileset_0": {
          "type": "loop",
          "start_id": 0,
          "count": 156,
          "pattern": {
              "prefix": "Tilesets/Dungeon\\tile",
              "digits": 3,
              "start": 0,
              "suffix": ".png"
          }
      },
      "tileset_1": {
          "type": "loop",
          "start_id": 156,
          "count": 234,
          "pattern": {
              "prefix": "Tilesets/Overworld\\tile",
              "digits": 3,
              "start": 0,
              "suffix": ".png"
          }
      },
      "390": {
          "path": "character/char_idle_down/tile000.png",
          "tileset": 2
      },
      "391": {
          "path": "Enemies_Sprites/Phantom_Sprites/phantom_idle_anim_right/tile000.png",
          "tileset": 2
      },
      "392": {
          "path": "Enemies_Sprites/Phantom_Sprites/phantom_idle_anim_left/tile000.png",
          "tileset": 2
      },
      "393": {
          "path": "Enemies_Sprites/Bomberplant_Sprites/bomberplant_idle_anim_all_dir/tile000.png",
          "tileset": 2
      },
      "394": {
          "path": "Enemies_Sprites/Spinner_Sprites/spinner_idle_anim_all_dir/tile000.png",
          "tileset": 2
      },
      "395": {
          "path": "Enemies_Sprites/Spider_Sprites/spider_idle_anim_all_dir/tile000.png",
          "tileset": 2
      },
      "396": {
          "path": "Enemies_Sprites/Pinkslime_Sprites/pinkslime_idle_anim_all_dir/tile000.png",
          "tileset": 2
      },
      "397": {
          "path": "Enemies_Sprites/Pinkbat_Sprites/pinkbat_idle_left_anim/tile000.png",
          "tileset": 2
      },
      "398": {
          "path": "Enemies_Sprites/Pinkbat_Sprites/pinkbat_idle_right_anim/tile000.png",
          "tileset": 2
      },
      "1000": {
          "path": "animated:edge_water_tile",
          "tileset": -1
      },
      "1001": {
          "path": "animated:regia_waterplant_tile",
          "tileset": -1
      },
      "1002": {
          "path": "animated:waterplant_tile",
          "tileset": -1
      },
      "1003": {
          "path": "animated:water_tile",
          "tileset": -1
      },
      "1004": {
          "path": "animated:key_item",
          "tileset": -1
      },
      "1005": {
          "path": "animated:crystal_item",
          "tileset": -1
      },
      "1006": {
          "path": "animated:lootchest_item",
          "tileset": -1
      }
  },
  "layers": [
    {
      "visible": true,
      "map_data": [
        [370, 370, 370, 370, 370, 370, 370, 370, 370, 370, 370, 370, 370, 370, 370, 370, 370, 370],
        [370, 370, 370, 370, 370, 370, 370, 370, 370, 370, 370, 370, 370, 370, 370, 370, 370, 370],
        [370, 370, 370, 370, 370, 370, 370, 370, 370, 370, 370, 370, 370, 370, 370, 370, 370, 370],
        [370, 370, 370, 370, 370, 370, 370, 370, 370, 370, 370, 370, 370, 370, 370, 370, 370, 370],
        [370, 370, 370, 370, 370, 370, 370, 370, 370, 370, 370, 370, 370, 370, 370, 370, 370, 370],
        [370, 370, 370, 370, 370, 370, 370, 370, 370, 370, 370, 370, 370, 370, 370, 370, 370, 370],
        [370, 370, 370, 370, 370, 370, 370, 370, 370, 370, 370, 370, 370, 370, 370, 370, 370, 370],
        [370, 370, 370, 370, 370, 370, 370, 370, 370, 370, 370, 370, 370, 370, 370, 370, 370, 370],
        [370, 370, 370, 370, 370, 370, 370, 370, 370, 288, 370, 370, 370, 370, 370, 370, 370, 370],
        [370, 370, 370, 370, 370, 370, 370, 370, 370, 370, 370, 370, 370, 370, 370, 370, 370, 370],
        [370, 370, 370, 370, 370, 370, 370, 370, 370, 370, 370, 370, 370, 370, 370, 370, 370, 370],
        [370, 370, 370, 370, 370, 370, 370, 370, 370, 370, 370, 370, 370, 370, 370, 370, 370, 370],
        [370, 370, 370, 370, 370, 370, 370, 370, 370, 370, 370, 370, 370, 370, 370, 370, 370, 370]
      ]
    },
    {
      "visible": true,
      "map_data": [
        [260, 261, 261, 261, 261, 261, 261, 261, 261, 261, 261, 261, 261, 261, 261, 261, 261, 263],
        [278, 280, 280, 280, 280, 280, 280, 280, 280, 280, 280, 280, 280, 280, 280, 280, 280, 281],
        [296, 298, 298, 298, 298, 298, 298, 298, 298, 298, 298, 298, 298, 298, 298, 298, 298, 299],
        [314, -1, 328, -1, -1, -1, -1, -1, -1, -1, 366, 385, 386, -1, 1006, -1, 1006, 317],
        [314, 329, 346, 330, -1, -1, -1, -1, -1, -1, 384, -1, -1, -1, -1, -1, -1, 317],
        [314, -1, -1, -1, -1, -1, -1, -1, -1, -1, -1, -1, -1, -1, -1, -1, -1, 317],
        [314, -1, -1, -1, -1, -1, -1, -1, -1, -1, -1, -1, -1, -1, -1, -1, -1, 317],
        [314, -1, -1, -1, -1, -1, -1, -1, -1, -1, -1, -1, -1, -1, -1, -1, -1, 317],
        [314, -1, -1, -1, -1, -1, -1, -1, -1, -1, -1, -1, -1, -1, -1, -1, -1, 317],
        [314, -1, -1, -1, -1, -1, -1, -1, -1, -1, -1, -1, -1, -1, -1, -1, -1, 317],
        [314, -1, -1, -1, -1, -1, -1, -1, -1, -1, -1, -1, -1, -1, -1, -1, -1, 317],
        [314, -1, -1, -1, -1, -1, -1, -1, -1, -1, -1, -1, -1, -1, -1, -1, -1, 317],
        [332, 333, 333, 333, 333, 333, 333, 333, 333, 333, 333, 333, 333, 333, 333, 333, 333, 335]
      ]
    },
    {
      "visible": true,
      "map_data": [
        [-1, -1, -1, -1, -1, -1, -1, -1, -1, -1, -1, -1, -1, -1, -1, -1, -1, -1],
        [-1, -1, -1, -1, -1, -1, -1, -1, -1, -1, 382, -1, -1, -1, -1, -1, -1, -1],
        [-1, -1, -1, -1, -1, -1, -1, -1, -1, -1, -1, 367, 368, -1, -1, -1, -1, -1],
        [-1, -1, -1, -1, -1, -1, -1, -1, -1, -1, -1, -1, -1, -1, -1, -1, -1, -1],
        [-1, -1, -1, -1, -1, -1, -1, -1, -1, -1, -1, -1, -1, -1, -1, -1, -1, -1],
        [-1, -1, -1, -1, -1, -1, -1, -1, -1, -1, -1, -1, -1, -1, -1, -1, -1, -1],
        [-1, -1, -1, -1, -1, -1, -1, -1, -1, -1, -1, -1, -1, -1, -1, -1, -1, -1],
        [-1, -1, -1, -1, -1, -1, -1, -1, -1, -1, -1, -1, -1, -1, -1, -1, -1, -1],
        [-1, -1, -1, -1, -1, -1, -1, -1, -1, -1, -1, -1, -1, -1, -1, -1, -1, -1],
        [-1, -1, -1, -1, -1, -1, -1, -1, -1, -1, -1, -1, -1, -1, -1, -1, -1, -1],
        [-1, -1, -1, -1, -1, -1, -1, -1, -1, -1, -1, -1, -1, -1, -1, -1, -1, -1],
        [-1, -1, -1, -1, -1, -1, -1, -1, -1, -1, -1, -1, -1, -1, -1, -1, -1, -1],
        [-1, -1, -1, -1, -1, -1, -1, -1, -1, -1, -1, -1, -1, -1, -1, -1, -1, -1]
      ]
    }
  ],
  "relation_points": {
      "1": {
          "b": [
              9,
              12
          ]
      }
  },
  "game_state": {
    "camera": {
      "x": 0.0,
      "y": 0.0
    },
    "enemies": [],
    "inventory": [],
    "collected_keys": [],
    "collected_crystals": [],
    "opened_lootchests": [],
    "chest_contents": {}
  }
}
